 #####
 #@$.#
 #####
;
 #######
##  .  ##
#   $   #
# .$@$. #
#   $   #
##  .  ##
 #######
;
 #########
##       #
#.@$    ##
#### $  .#
#. ##$  ##
#  #     #
#    $$  #
#   .   .#
##########
;
##########
#...#    ##
#   # $   #
# $ #  #  #
#   #### ##
## ##     #
# @     $ #
##        #
 ##########
;
  ##### 
###   # 
#.@$  # 
### $.# 
#.##$ # 
# # . ##
#$  $$.#
#   .  #
########