#####
#@$.#
#####
;
#########
#   .   #
#   $   #
# .$@$. #
#   $   #
#   .   #
#########
;
 ##########
##        #
#.@$     ##
#### $   .#
#. ##$   ##
#  #      #
#    $$   #
#   .    .#
###########
;
############
#...#      ##
#   # $     #
# $ #  #    #
#   ####  ###
## ##       #
# @       $ #
##          #
 ############